############################
#............##............#
#,#####.####.##.#####.####,#
#.#####.####.##.#####.####.#
#.#####.####.##.#####.####.#
#..........................#
##.####.############.####.##
#..........................#
#.#####.#### ## ####.#####.#
#.......#.#      # #.......#
#.##.##.#.###--###.#.##.##.#
#.##.##.#.##    ##.#.##.##.#
#.##.##.#.########.#.##.##.#
#.##.##..............##.##.#
#.##.##.############.##.##.#
#............##............#
#,##.##.####.##.####.##.##,#
#.##.##.####.##.####.##.##.#
#..........................#
#.#####.####.##.#####.####.#
#..........................#
############################