############################
#......#...................#
#.#.#.#.#.##.##.##.##.##.#.#
###.,...#.##.##..#.#...#####
#.#.#.#.####.##.##.##.##.#.#
#...#..................#.,.#
##.#.##..###.##.##.#.#.##.##
#............##............#
#.#####.#### ## ##########.#
#.....#.#. *      ..#......#
#.##.##.#.###--###..#.#.#.##
##...##.#..#@@@@#...#.#.#.##
####.##.#.########..#.#.#.##
##,..##.................#.##
#.##.##.##.#####.##.#.#.#.##
#.....#......##.....###....#
#.#.#.#.####.##.##.#.###,#.#
###.#.#.####.##.##.#.#.#.#.#
#.#.#.#..............#.....#
#.#.#.#.#.##.##.#.###..###.#
#.....#.............#....#.#
############################