############################
#............##............#
#.#.#.#.#.##.##.##.##.####.#
#.#.,...#.##.##.##.##.####.#
#.#####.####.##.##.##.####.#
#...#..................#.,.#
##.#.##..###.##.##.#.#.##.##
#..........................#
#.#####.#### ## ####.#####.#
#.....#... *      .........#
##.#.##.#.###--###..#.#.#.##
##.#.##.#.##@@@@##..#.#.#.##
##.#,##.#.########..#.#.#.##
##.#.##.............#.#.#.##
##.#.##.##.########.#.#.#.##
#.....#......##.....###....#
#.#.#.#.####.##.##.#.###,#.#
###.#.#.####.##.##.#.#.#.#.#
#.#.#.#..............#.###.#
#.#.#.#.####.##.#####..###.#
#..........................#
############################